##############################################################################
##........#.....#.....##.....##.......########..#######.......################
##.#.####...#####.###..#.###....##.##......##...#######..###...###############
#..#.######.#####.####...#####.###.#####.#......#######..###.#.....###########
#.##.######.#####.############.###.#####.#####..#######..###.#.###.###########
#.##.######..####.############.###.#####.#####...........###.#.###.###########
#.#..#####....###.############.##..####.........############...###.###########
#.#.###....##.........########.##.#####.####....#############..###.###########
#.#..##.#########.###..#######.##.####..####################...##..###########
#.##.##.#########.####.#######.....###.#####################......############
#.##.##.#########.####.#######.###.....######################.###.#####.....##
#.##.##.#########.####.#######..###..########################.###.#####.###.##
#.##.#............................#..########################.###.#####.###.##
#......##########.###..########..............................................#
#.....#####........##.###...###......########################.###..####.###..#
###...#####.#.###..##.....#......############################......####.###..#
###...#####.#.###.###.####...........#################################..###..#
##.....####.#.##..###.####.#########.#################################.####..#
#..#..........##.####..###.#########.##############################..........#
#.##....###..###.####..###.......###.##############################.#...###.##
#.##..#..........####..###..#..#.....##############################.........##
##############################################################################
