........~..#......^....^.^....~...~.........................^..^........^.....
.........~.#.......^^^^^^.^....................~......^...^^..^^........^...^.
............###......^.^..^...^........................^.......^~....^........
.....................^..^............^.............~...^........^..^..........
............~........^^^..^.......^^..^..........^^.^..........~..............
.....................~^..^...^^....^..........~^.^...^..............^.........
....~..............^..........^......^........~..^^^...................~......
.....~.........^......^.......^^.^............~...^.^...^^..^..^~.......~.....
..........~.~...^^.^^^.......^^..^...^...............^.....^..................
..............~...^...^~..~.^..^^^................^..^........^..^............
.................^...^..^..^...^^.^..........^...^..^^..^...^........#........
.............#.^........^ ...~...^.^^.....~...^.....^^.....~....^###.#........
..~.....~....#.~.......  ....^.^^............^..............^.....###.........
.#...........#.......  .......^.^................^.........^.......#..........
.##...........#.#...  ....~....^^^......^..^...............#......~......~...~
.##.........~.##.#....................^..^..........^...^..#..^...............
...###......~..##.#.....................^....^^^........^.#...............#~..
...###......~..#..........................~..^...^.^......#................#..
....##......................................^...^.^.^.^...#................#..
.....#...............~.~.................^.^.....^^..^..##..................#.
........................................^^....^..^.^^....##.....~............#
...............................~..............~...^.........................##
